█████████████████████████████████████████████████████████████████████████████████████████████████████████████████████
██          ██                    ██           ████      ██      ██                      ████████                  ██
██          ██                    ██           ██    ██      ██      ████    ██          ██    ██                  ██
██                                             ██  ██████████████████████    ██          ████  ██                  ██
██                                             ██    ███████████    █████    ██                ██                  ██
██          ██                    ██           ████    ███          █████    ████████████████  ██                  ██
██          ██                    ██           ██████         ██████████    ███                ██                  ██
██████████████████████    ██████████████████████████████████  ████████    ███████████████████████                  ██
██          ██                    ██           ███    ████    ██████                           ██                  ██
██          ██                    ██           ███    ██    ██████                             ██                  ██
██                                             ███          ████                               ██                  ██
██                                             ███    ██    ██                                 ██                  ██
██          ████████████████████████           █████████████                                   ████    ██████████████
██          ██                    ██                                             ███████       ██                  ██
██          ██                    ██                                                  ██       ██                  ██
██          ██████████████    ██████           ██                                ██   ██       ██                  ██
██                ██    ██        ██           ██                                ██   ██       ██                  ██
██                ██    ██        ██           ██                                ██   ███████████                  ██
██          ██    ██    ██                     ██                                ██                                ██
██          ██          ██                     ██                                ██                                ██
█████    ██████████████████████████████    █████████    ██████████████████████████████    ███████████████████████████
██          ██                    ██           ██          ██                    ██           ██                   ██
██          ██                    ██           ██          ██                    ██           ██                   ██
██                                                                                                                 ██
██                                                                                                                 ██
██          ██                    ██           ██          ██                    ██           ██                   ██
██          ██                    ██           ██          ██                    ██           ██                   ██
█████████████████████    ███████████████████████████████████████████    ███████████████████████████    ██████████████
██          ██                    ██           ██          ██                    ██           ██                   ██
██          ██                    ██           ██          ██                    ██           ██                   ██
██                                                                                                                 ██
██                                                                                                                 ██
██          ██                    ██           ██          ██                    ██           ██                   ██
██          ██                    ██           ██          ██                    ██           ██                   ██
█████████████████████████████████████████████████████████████████████████████████████████████████████████████████████