╔════╦═════════╗                                                                                ╔══════════════╗
║    ║         ║                                                                                ║              ║
║    ║         ║                                                                                ║    ╔═══╗     ║
║    ║   ╔═════╩═══════════════╗                                                ╔═══════════════╝        ║     ║
║    ║   ║                     ║                                                ║                        ║     ║
║    ║                         ║                                                ║                    ║   ║     ║
║    ║         ╔══════════╗    ║                                                ║    ╔══════════╦════╝   ║     ║
║    ╚═══╝     ║          ║    ║                                                ║    ║          ║        ║     ║
║              ║          ║    ║                                                ║    ║          ║        ║     ║
╚══════════════╝          ║    ║                                                ║    ║          ╚════════╩═════╝
                          ║    ║                                                ║    ║                          
                          ║    ║                                                ║    ║                          
                    ╔═════╣    ╠═════╗          ╔════╦═══╦═════╗          ╔═════╣    ╠═════╗                    
                    ║     ║    ║     ║          ║    ║   ║     ║          ║     ║    ║     ║                    
                    ╠═  ══╝    ╚══  ═╣          ║        ║     ║          ╠═  ══╝    ╚══  ═╣                    
                    ║                ╚══════════╝    ║   ║     ╚══════════╝                ║                    
                    ║     ╔════╗                     ║                          ╔════╗     ║                    
                    ║     ╚════╝                     ║                          ╚════╝     ║                    
                    ║                ╔══════════╗    ║   ║     ╔══════════╗                ║                    
                    ╠═  ══╗    ╔══  ═╣          ║        ║     ║          ╠═  ══╗    ╔══  ═╣                    
                    ║     ║    ║     ║          ║    ║   ║     ║          ║     ║    ║     ║                    
                    ╚═════╣    ╠═════╝          ╚════╩═══╩═════╝          ╚═════╣    ╠═════╝                    
                          ║    ║                                                ║    ║
                          ║    ║                                                ║    ║
╔══════════════╗          ║    ║                                                ║    ║          ╔════╦═════════╗
║              ║          ║    ║                                                ║    ║          ║    ║         ║
║    ╔═══╗     ║          ║    ║                                                ║    ║          ║    ║         ║
║        ║     ╚══════════╝    ║                                                ║    ╚══════════╝    ║   ╔═════╣
║        ║                     ║                                                ║                    ║   ║     ║
║    ║   ║                     ║                                                ║                    ║         ║
╠════╝   ║     ╔═══════════════╝                                                ╚═══════════════╗    ║         ║
║        ║     ║                                                                                ║    ╚═══╝     ║
║        ║     ║                                                                                ║              ║
╚════════╩═════╝                                                                                ╚══════════════╝