█████████████████████████████████████████████████████████████████████████████████████████████████████████████████████
██          ██                    ██           ████      ██      ██                      ████████                  ██
██          ██                    ██           ██    ██      ██      ████    ██          ██    ██                  ██
██                                             ██  ██████████████████████    ██          ████  ██                  ██
██                                             ██    ███████████    █████    ██                ██                  ██
██          ██                    ██           ████    ███          █████    ████████████████  ██                  ██
██          ██                    ██           ██████         ██████████    ███                ██                  ██
██████████████████████    ██████████████████████████████████  ████████    ███████████████████████                  ██
██          ██                    ██           ███    ████    ██████                           ██                  ██
██          ██                    ██           ███    ██    ██████                             ██                  ██
██                                             ███          ████                               ██                  ██
██                                             ███    ██    ██                                 ██                  ██
██          ████████████████████████           █████████████                                   ████   ███████████████
██          ██                    ██                                             ███████       ██                  ██
██          ██                    ██                                                  ██       ██                  ██
██          ██████████████    ██████           ██                                ██   ██       ██                  ██
██                ██    ██        ██           ██                                ██   ██       ██                  ██
██                ██    ██        ██           ██                                ██   ███████████                  ██
██          ██    ██    ██                     ██                                ██                                ██
██          ██          ██                     ██                                ██                                ██
█████████████████████████████████████████████████████████████████████████████████████████████████████████████████████

█████████████████████████████████████████████      █████████████████████████████████████████
█                    █                      █      █                                       █
█                    █                      █      █                                       █
█                    █                      █      █                                       █
█                    █                      █      █                                       █
█                    █                      █      █                                       █
█████████████████████████████████████████████      █████████████████████████████████████████