█████████████████████████████████████████████████████████████████████████████████████████████████
██          ██                    ██           ████      ██      ██    ██                ████████
██          ██                    ██           ██    ██      ██      ████    ██          ██    ██
██                                             ██  ██████████████████████    ██          ████  ██
██                                             ██    ███████████    █████    ██                ██
██          ██                    ██           ████    ███          █████    ████████████████████
██          ██                    ██           ██████         ██████████    █████████████████████
██████████████████████    ██████████████████████████████████  ████████    ███████████████████████
██          ██                    ██           ███    ████    ██████                           ██
██          ██                    ██           ███    ██    ██████                             ██
██                                             ███          ████                               ██
██                                             ███    ██    ██                                 ██
██          ████████████████████████           █████████████                                   ██
██          ██                    ██                                                           ██
██          ██                    ██                                                           ██
██          ██████████████    ██████           ██                                              ██
██                ██    ██        ██           ██                                              ██
██                ██    ██        ██           ██                                              ██
██          ██    ██    ██                     ██                                              ██
██          ██          ██                     ██                                              ██
█████████████████████████████████████████████████████████████████████████████████████████████████